1111111111111111111111111111111111
1E0000000000000C00000C000000000001
101001010010000M101001000000010101
101001001010101000100M000000010101
1P0000000C00C0000M00000000000000C1
1111111111111111111111111111111110
